#####################################################
#                                                   #
#   #######    #######             #######    ###   #
#   #     #          #             #            #   #
#   #          #######    #####    #######    ###   #
#   #     #    #          #   #          #      #   #
#   #######    #######    #        #######    ###   #
#                         #   #                     #
#   #######    #######    #####    #######    ###   #
#   #            #                       #      #   #
#   #######    #######             #######    ###   #
#                                                   #
#   #######    #######    #####    #######    ###   #
#   #     #    #              #          #      #   #
#   #          #######    #####    #######    ###   #
#   #     #          #                 #        #   #
#   #######    #######             #######    ###   #
#                                                   #
#   ###    #######    #######    #######    #####   #
#   #      #                #    #              #   #
#   ###    #######    #######    #######    #####   #
#                                                   #
#####################################################